########################################
#......................................#
#................######................#
#..................##..................#
##########.........##.........##########
#..................##..................#
#..................##..................#
#..................##..................#
##########.........##.........##########
#..................##..................#
#..................##..................#
#..................##..................#
#..................##..................#
#..................##..................#
#........#######################.......#
#........#######################.......#
#..................##..................#
#..................##..................#
#..................##..................#
#..................##..................#
#..................##..................#
##########.........##.........##########
#..................##..................#
#..................##..................#
#..................##..................#
##########.........##.........##########
#..................##..................#
#................######................#
#......................................#
########################################