########################################
#......................................#
#......................................#
#......................................#
#......................................#
#......................................#
############................############
##############............##############
#......................................#
#......................................#
#......................................#
#......................................#
#......................................#
#......................................#
#......................................#
#......................................#
#......................................#
#......................................#
#......................................#
#......................................#
#......................................#
#......................................#
#......................................#
##############.............#############
#......................................#
#......................................#
#......................................#
#......................................#
#......................................#
########################################